Yellow Team Demo
An Interactive Fiction by Matt
Release 1 / Serial number 221022 / Inform 7 v10.1.2 / D

Classroom
"Hey, hey wake up! We fell asleep!" You groggily awaken, fleeting thoughts of your dreams slowly dissipate from your memory as you begin to recall where you are. You look around the room calmly for a moment, then reality sets in. Your eyes widen and the panic hits you… You fell asleep studying and your exam is in… wait, what time is it? 

You can see a normal door and a backpack (in which is a phone) here.

>look
Classroom
Here's the normal text.

You can see a normal door, a key and a backpack (closed) here.

>open backpack
You open the backpack, revealing a phone.

>look
Classroom
Here's the normal text.

You can see a normal door, a key and a backpack (in which is a phone) here.

>take phone
Taken.

>use
That's not a verb I recognise.

* * *

Yellow Team Demo
An Interactive Fiction by Matt
Release 1 / Serial number 221022 / Inform 7 v10.1.2 / D

Classroom
"Hey, hey wake up! We fell asleep!" You groggily awaken, fleeting thoughts of your dreams slowly dissipate from your memory as you begin to recall where you are. You look around the room calmly for a moment, then reality sets in. Your eyes widen and the panic hits you… You fell asleep studying and your exam is in… wait, what time is it? 

You can see a normal door and a backpack (in which is a phone) here.

>open backpack
That's already open.

>look backpack
In the backpack is a Phone.

>take phone
You can't see any such thing.

* * *

>open backpack
That's already open.

>take phone
Taken.

>use phone
That's not a verb I recognise.

* * *

Yellow Team Demo
An Interactive Fiction by Matt
Release 1 / Serial number 221022 / Inform 7 v10.1.2 / D

Classroom
"Hey, hey wake up! We fell asleep!" You groggily awaken, fleeting thoughts of your dreams slowly dissipate from your memory as you begin to recall where you are. You look around the room calmly for a moment, then reality sets in. Your eyes widen and the panic hits you… You fell asleep studying and your exam is in… wait, what time is it? 

You can see a normal door and a backpack (in which is a phone) here.

>open door
You open the normal door.

>close door
You close the normal door.

>enter door
(first opening the normal door)

Computer Room
 It looks like a nerds heaven

You can see a normal door here.

* * *

>open door
You open the normal door.

>eneter door
That's not a verb I recognise.

>enter door
Computer Room
 The Computer Room loos like a nerds heaven

You can see a normal door here.

>enter door
Classroom
Here's the normal text.

You can see a normal door and a key here.